XHHHHHHHHHHHHHHHHHHHHHHHX
V                       V
V                       V
V                T      V
V                       V
V                       V
V           XHHX        V
V                       V
V                       V
V                       V
V            P          V
V                       V
V                       V
V           XHHX        V
V                       V
V                       V
V                T      V
V                       V
V                       V
XHHHHHHHHHHHHHHHHHHHHHHHX