XHHHHHHHHHHHHHHHHHHHHHHHX
V                       V
V                       V
V           P           V
V                       V
V                       V
V                       V
V                       V
V      HHHHHHHHHHH      V
V                       V
V                       V
V                       V
V                       V
V                       V
V        T     T        V
V                       V
V                       V
V                       V
V                       V
XHHHHHHHHHHHHHHHHHHHHHHHX