XHHHHHHHHHHHHHHHHHHHHHHHX
V                       V
V                       V
V           T           V
V                       V
V                       V
VHHHHHHHHHHX            V
V                       V
V                       V
V                       V
V            XHHHHHHHHHHV
V                       V
V                       V
V                       V
VHHHHHHHHHHX            V
V                       V
V                       V
V     P                 V
V                       V
XHHHHHHHHHHHHHHHHHHHHHHHX